####################
#..................#
#..................#
#..................#
#..................#
#..................#
#..................#
#.......####.......#
#.......#..#.......#
#.......##S#.......#
#..................#
#..................#
#..................#
#..................#
####################