##D#S#####
#........#
#........#
#........#
#........#
#........#
#.......~#
#.....~~~#
#....~~~~#
##########